***Tables***	
Name="admin_country"	REID="mdw.admin_country"; Selected="False"; FullName="mdw.admin_country"; Catalog=""
Name="admin_hosted_client"	REID="mdw.admin_hosted_client"; Selected="False"; FullName="mdw.admin_hosted_client"; Catalog=""
Name="admin_job_control"	REID="mdw.admin_job_control"; Selected="False"; FullName="mdw.admin_job_control"; Catalog=""
Name="admin_module"	REID="mdw.admin_module"; Selected="False"; FullName="mdw.admin_module"; Catalog=""
Name="admin_module_mondrian_object"	REID="mdw.admin_module_mondrian_object"; Selected="False"; FullName="mdw.admin_module_mondrian_object"; Catalog=""
Name="admin_module_partner"	REID="mdw.admin_module_partner"; Selected="False"; FullName="mdw.admin_module_partner"; Catalog=""
Name="admin_module_table"	REID="mdw.admin_module_table"; Selected="False"; FullName="mdw.admin_module_table"; Catalog=""
Name="admin_module_table_table"	REID="mdw.admin_module_table_table"; Selected="False"; FullName="mdw.admin_module_table_table"; Catalog=""
Name="admin_mondrian_object"	REID="mdw.admin_mondrian_object"; Selected="False"; FullName="mdw.admin_mondrian_object"; Catalog=""
Name="admin_mondrian_object_bak"	REID="mdw.admin_mondrian_object_bak"; Selected="False"; FullName="mdw.admin_mondrian_object_bak"; Catalog=""
Name="admin_partner"	REID="mdw.admin_partner"; Selected="False"; FullName="mdw.admin_partner"; Catalog=""
Name="admin_partner_country"	REID="mdw.admin_partner_country"; Selected="False"; FullName="mdw.admin_partner_country"; Catalog=""
Name="admin_role"	REID="mdw.admin_role"; Selected="False"; FullName="mdw.admin_role"; Catalog=""
Name="admin_transformation_control"	REID="mdw.admin_transformation_control"; Selected="False"; FullName="mdw.admin_transformation_control"; Catalog=""
Name="admin_user"	REID="mdw.admin_user"; Selected="False"; FullName="mdw.admin_user"; Catalog=""
Name="admin_user_role"	REID="mdw.admin_user_role"; Selected="False"; FullName="mdw.admin_user_role"; Catalog=""
Name="bridge_customer_campaign_wave"	REID="mdw.bridge_customer_campaign_wave"; Selected="False"; FullName="mdw.bridge_customer_campaign_wave"; Catalog=""
Name="dimension_account"	REID="mdw.dimension_account"; Selected="False"; FullName="mdw.dimension_account"; Catalog=""
Name="dimension_advertisement"	REID="mdw.dimension_advertisement"; Selected="False"; FullName="mdw.dimension_advertisement"; Catalog=""
Name="dimension_advertisement_status"	REID="mdw.dimension_advertisement_status"; Selected="False"; FullName="mdw.dimension_advertisement_status"; Catalog=""
Name="dimension_advertisement_type"	REID="mdw.dimension_advertisement_type"; Selected="False"; FullName="mdw.dimension_advertisement_type"; Catalog=""
Name="dimension_application_status"	REID="mdw.dimension_application_status"; Selected="False"; FullName="mdw.dimension_application_status"; Catalog=""
Name="dimension_bank_account"	REID="mdw.dimension_bank_account"; Selected="False"; FullName="mdw.dimension_bank_account"; Catalog=""
Name="dimension_bill_status"	REID="mdw.dimension_bill_status"; Selected="False"; FullName="mdw.dimension_bill_status"; Catalog=""
Name="dimension_bill_type"	REID="mdw.dimension_bill_type"; Selected="False"; FullName="mdw.dimension_bill_type"; Catalog=""
Name="dimension_budget_forecast"	REID="mdw.dimension_budget_forecast"; Selected="False"; FullName="mdw.dimension_budget_forecast"; Catalog=""
Name="dimension_budget_forecast_item"	REID="mdw.dimension_budget_forecast_item"; Selected="False"; FullName="mdw.dimension_budget_forecast_item"; Catalog=""
Name="dimension_business_unit"	REID="mdw.dimension_business_unit"; Selected="False"; FullName="mdw.dimension_business_unit"; Catalog=""
Name="dimension_call_result"	REID="mdw.dimension_call_result"; Selected="False"; FullName="mdw.dimension_call_result"; Catalog=""
Name="dimension_call_type"	REID="mdw.dimension_call_type"; Selected="False"; FullName="mdw.dimension_call_type"; Catalog=""
Name="dimension_campaign"	REID="mdw.dimension_campaign"; Selected="False"; FullName="mdw.dimension_campaign"; Catalog=""
Name="dimension_campaign_objective"	REID="mdw.dimension_campaign_objective"; Selected="False"; FullName="mdw.dimension_campaign_objective"; Catalog=""
Name="dimension_campaign_status"	REID="mdw.dimension_campaign_status"; Selected="False"; FullName="mdw.dimension_campaign_status"; Catalog=""
Name="dimension_campaign_subtype"	REID="mdw.dimension_campaign_subtype"; Selected="False"; FullName="mdw.dimension_campaign_subtype"; Catalog=""
Name="dimension_campaign_type"	REID="mdw.dimension_campaign_type"; Selected="False"; FullName="mdw.dimension_campaign_type"; Catalog=""
Name="dimension_campaign_wave"	REID="mdw.dimension_campaign_wave"; Selected="False"; FullName="mdw.dimension_campaign_wave"; Catalog=""
Name="dimension_campaign_wave_status"	REID="mdw.dimension_campaign_wave_status"; Selected="False"; FullName="mdw.dimension_campaign_wave_status"; Catalog=""
Name="dimension_campaign_wave_temp"	REID="mdw.dimension_campaign_wave_temp"; Selected="False"; FullName="mdw.dimension_campaign_wave_temp"; Catalog=""
Name="dimension_carrier"	REID="mdw.dimension_carrier"; Selected="False"; FullName="mdw.dimension_carrier"; Catalog=""
Name="dimension_case"	REID="mdw.dimension_case"; Selected="False"; FullName="mdw.dimension_case"; Catalog=""
Name="dimension_case_priority"	REID="mdw.dimension_case_priority"; Selected="False"; FullName="mdw.dimension_case_priority"; Catalog=""
Name="dimension_case_severity"	REID="mdw.dimension_case_severity"; Selected="False"; FullName="mdw.dimension_case_severity"; Catalog=""
Name="dimension_case_status"	REID="mdw.dimension_case_status"; Selected="False"; FullName="mdw.dimension_case_status"; Catalog=""
Name="dimension_classification"	REID="mdw.dimension_classification"; Selected="False"; FullName="mdw.dimension_classification"; Catalog=""
Name="dimension_company"	REID="mdw.dimension_company"; Selected="False"; FullName="mdw.dimension_company"; Catalog=""
Name="dimension_company_paygroup"	REID="mdw.dimension_company_paygroup"; Selected="False"; FullName="mdw.dimension_company_paygroup"; Catalog=""
Name="dimension_contract"	REID="mdw.dimension_contract"; Selected="False"; FullName="mdw.dimension_contract"; Catalog=""
Name="dimension_cost_center"	REID="mdw.dimension_cost_center"; Selected="False"; FullName="mdw.dimension_cost_center"; Catalog=""
Name="dimension_currency"	REID="mdw.dimension_currency"; Selected="False"; FullName="mdw.dimension_currency"; Catalog=""
Name="dimension_customer"	REID="mdw.dimension_customer"; Selected="False"; FullName="mdw.dimension_customer"; Catalog=""
Name="dimension_customer_contact"	REID="mdw.dimension_customer_contact"; Selected="False"; FullName="mdw.dimension_customer_contact"; Catalog=""
Name="dimension_day"	REID="mdw.dimension_day"; Selected="False"; FullName="mdw.dimension_day"; Catalog=""
Name="dimension_day_temp"	REID="mdw.dimension_day_temp"; Selected="False"; FullName="mdw.dimension_day_temp"; Catalog=""
Name="dimension_department"	REID="mdw.dimension_department"; Selected="False"; FullName="mdw.dimension_department"; Catalog=""
Name="dimension_document_type"	REID="mdw.dimension_document_type"; Selected="False"; FullName="mdw.dimension_document_type"; Catalog=""
Name="dimension_employee_job_action"	REID="mdw.dimension_employee_job_action"; Selected="False"; FullName="mdw.dimension_employee_job_action"; Catalog=""
Name="dimension_fiscal_period"	REID="mdw.dimension_fiscal_period"; Selected="False"; FullName="mdw.dimension_fiscal_period"; Catalog=""
Name="dimension_fund"	REID="mdw.dimension_fund"; Selected="False"; FullName="mdw.dimension_fund"; Catalog=""
Name="dimension_geographic_location"	REID="mdw.dimension_geographic_location"; Selected="False"; FullName="mdw.dimension_geographic_location"; Catalog=""
Name="dimension_gl_adjustment"	REID="mdw.dimension_gl_adjustment"; Selected="False"; FullName="mdw.dimension_gl_adjustment"; Catalog=""
Name="dimension_gl_book"	REID="mdw.dimension_gl_book"; Selected="False"; FullName="mdw.dimension_gl_book"; Catalog=""
Name="dimension_inventory_adjustment"	REID="mdw.dimension_inventory_adjustment"; Selected="False"; FullName="mdw.dimension_inventory_adjustment"; Catalog=""
Name="dimension_job_action"	REID="mdw.dimension_job_action"; Selected="False"; FullName="mdw.dimension_job_action"; Catalog=""
Name="dimension_jobcode"	REID="mdw.dimension_jobcode"; Selected="False"; FullName="mdw.dimension_jobcode"; Catalog=""
Name="dimension_keyword_matching"	REID="mdw.dimension_keyword_matching"; Selected="False"; FullName="mdw.dimension_keyword_matching"; Catalog=""
Name="dimension_keyword_phrase"	REID="mdw.dimension_keyword_phrase"; Selected="False"; FullName="mdw.dimension_keyword_phrase"; Catalog=""
Name="dimension_keyword_status"	REID="mdw.dimension_keyword_status"; Selected="False"; FullName="mdw.dimension_keyword_status"; Catalog=""
Name="dimension_ledger"	REID="mdw.dimension_ledger"; Selected="False"; FullName="mdw.dimension_ledger"; Catalog=""
Name="dimension_location"	REID="mdw.dimension_location"; Selected="False"; FullName="mdw.dimension_location"; Catalog=""
Name="dimension_marketing_channel"	REID="mdw.dimension_marketing_channel"; Selected="False"; FullName="mdw.dimension_marketing_channel"; Catalog=""
Name="dimension_marketing_segment"	REID="mdw.dimension_marketing_segment"; Selected="False"; FullName="mdw.dimension_marketing_segment"; Catalog=""
Name="dimension_month"	REID="mdw.dimension_month"; Selected="False"; FullName="mdw.dimension_month"; Catalog=""
Name="dimension_msa"	REID="mdw.dimension_msa"; Selected="False"; FullName="mdw.dimension_msa"; Catalog=""
Name="dimension_operating_unit"	REID="mdw.dimension_operating_unit"; Selected="False"; FullName="mdw.dimension_operating_unit"; Catalog=""
Name="dimension_order_capture"	REID="mdw.dimension_order_capture"; Selected="False"; FullName="mdw.dimension_order_capture"; Catalog=""
Name="dimension_order_status"	REID="mdw.dimension_order_status"; Selected="False"; FullName="mdw.dimension_order_status"; Catalog=""
Name="dimension_order_type"	REID="mdw.dimension_order_type"; Selected="False"; FullName="mdw.dimension_order_type"; Catalog=""
Name="dimension_partner"	REID="mdw.dimension_partner"; Selected="False"; FullName="mdw.dimension_partner"; Catalog=""
Name="dimension_partner_contact"	REID="mdw.dimension_partner_contact"; Selected="False"; FullName="mdw.dimension_partner_contact"; Catalog=""
Name="dimension_payment_method"	REID="mdw.dimension_payment_method"; Selected="False"; FullName="mdw.dimension_payment_method"; Catalog=""
Name="dimension_payment_terms"	REID="mdw.dimension_payment_terms"; Selected="False"; FullName="mdw.dimension_payment_terms"; Catalog=""
Name="dimension_person"	REID="mdw.dimension_person"; Selected="False"; FullName="mdw.dimension_person"; Catalog=""
Name="dimension_position"	REID="mdw.dimension_position"; Selected="False"; FullName="mdw.dimension_position"; Catalog=""
Name="dimension_product"	REID="mdw.dimension_product"; Selected="False"; FullName="mdw.dimension_product"; Catalog=""
Name="dimension_product_lot"	REID="mdw.dimension_product_lot"; Selected="False"; FullName="mdw.dimension_product_lot"; Catalog=""
Name="dimension_program"	REID="mdw.dimension_program"; Selected="False"; FullName="mdw.dimension_program"; Catalog=""
Name="dimension_project"	REID="mdw.dimension_project"; Selected="False"; FullName="mdw.dimension_project"; Catalog=""
Name="dimension_provider_group"	REID="mdw.dimension_provider_group"; Selected="False"; FullName="mdw.dimension_provider_group"; Catalog=""
Name="dimension_quarter"	REID="mdw.dimension_quarter"; Selected="False"; FullName="mdw.dimension_quarter"; Catalog=""
Name="dimension_recruitment_channel"	REID="mdw.dimension_recruitment_channel"; Selected="False"; FullName="mdw.dimension_recruitment_channel"; Catalog=""
Name="dimension_recruitment_event"	REID="mdw.dimension_recruitment_event"; Selected="False"; FullName="mdw.dimension_recruitment_event"; Catalog=""
Name="dimension_region"	REID="mdw.dimension_region"; Selected="False"; FullName="mdw.dimension_region"; Catalog=""
Name="dimension_return_reason"	REID="mdw.dimension_return_reason"; Selected="False"; FullName="mdw.dimension_return_reason"; Catalog=""
Name="dimension_return_type"	REID="mdw.dimension_return_type"; Selected="False"; FullName="mdw.dimension_return_type"; Catalog=""
Name="dimension_salary_plan"	REID="mdw.dimension_salary_plan"; Selected="False"; FullName="mdw.dimension_salary_plan"; Catalog=""
Name="dimension_sales_channel"	REID="mdw.dimension_sales_channel"; Selected="False"; FullName="mdw.dimension_sales_channel"; Catalog=""
Name="dimension_sales_lead"	REID="mdw.dimension_sales_lead"; Selected="False"; FullName="mdw.dimension_sales_lead"; Catalog=""
Name="dimension_sales_lead_channel"	REID="mdw.dimension_sales_lead_channel"; Selected="False"; FullName="mdw.dimension_sales_lead_channel"; Catalog=""
Name="dimension_sales_lead_type"	REID="mdw.dimension_sales_lead_type"; Selected="False"; FullName="mdw.dimension_sales_lead_type"; Catalog=""
Name="dimension_sales_opportunity"	REID="mdw.dimension_sales_opportunity"; Selected="False"; FullName="mdw.dimension_sales_opportunity"; Catalog=""
Name="dimension_shipment_priority"	REID="mdw.dimension_shipment_priority"; Selected="False"; FullName="mdw.dimension_shipment_priority"; Catalog=""
Name="dimension_shipment_route"	REID="mdw.dimension_shipment_route"; Selected="False"; FullName="mdw.dimension_shipment_route"; Catalog=""
Name="dimension_shipment_type"	REID="mdw.dimension_shipment_type"; Selected="False"; FullName="mdw.dimension_shipment_type"; Catalog=""
Name="dimension_source_system"	REID="mdw.dimension_source_system"; Selected="False"; FullName="mdw.dimension_source_system"; Catalog=""
Name="dimension_statistics"	REID="mdw.dimension_statistics"; Selected="False"; FullName="mdw.dimension_statistics"; Catalog=""
Name="dimension_subledger"	REID="mdw.dimension_subledger"; Selected="False"; FullName="mdw.dimension_subledger"; Catalog=""
Name="dimension_supplier"	REID="mdw.dimension_supplier"; Selected="False"; FullName="mdw.dimension_supplier"; Catalog=""
Name="dimension_time"	REID="mdw.dimension_time"; Selected="False"; FullName="mdw.dimension_time"; Catalog=""
Name="dimension_time_report_code"	REID="mdw.dimension_time_report_code"; Selected="False"; FullName="mdw.dimension_time_report_code"; Catalog=""
Name="dimension_transaction_status"	REID="mdw.dimension_transaction_status"; Selected="False"; FullName="mdw.dimension_transaction_status"; Catalog=""
Name="dimension_transaction_type"	REID="mdw.dimension_transaction_type"; Selected="False"; FullName="mdw.dimension_transaction_type"; Catalog=""
Name="dimension_unit_of_measure"	REID="mdw.dimension_unit_of_measure"; Selected="False"; FullName="mdw.dimension_unit_of_measure"; Catalog=""
Name="dimension_warehouse"	REID="mdw.dimension_warehouse"; Selected="False"; FullName="mdw.dimension_warehouse"; Catalog=""
Name="dimension_web_browser_os"	REID="mdw.dimension_web_browser_os"; Selected="False"; FullName="mdw.dimension_web_browser_os"; Catalog=""
Name="dimension_web_file"	REID="mdw.dimension_web_file"; Selected="False"; FullName="mdw.dimension_web_file"; Catalog=""
Name="dimension_web_navigation_path"	REID="mdw.dimension_web_navigation_path"; Selected="False"; FullName="mdw.dimension_web_navigation_path"; Catalog=""
Name="dimension_web_site_referer"	REID="mdw.dimension_web_site_referer"; Selected="False"; FullName="mdw.dimension_web_site_referer"; Catalog=""
Name="dimension_web_visitor"	REID="mdw.dimension_web_visitor"; Selected="False"; FullName="mdw.dimension_web_visitor"; Catalog=""
Name="dimension_week"	REID="mdw.dimension_week"; Selected="False"; FullName="mdw.dimension_week"; Catalog=""
Name="dimension_work_order_category"	REID="mdw.dimension_work_order_category"; Selected="False"; FullName="mdw.dimension_work_order_category"; Catalog=""
Name="dimension_work_order_phase"	REID="mdw.dimension_work_order_phase"; Selected="False"; FullName="mdw.dimension_work_order_phase"; Catalog=""
Name="dimension_work_order_status"	REID="mdw.dimension_work_order_status"; Selected="False"; FullName="mdw.dimension_work_order_status"; Catalog=""
Name="dimension_work_order_type"	REID="mdw.dimension_work_order_type"; Selected="False"; FullName="mdw.dimension_work_order_type"; Catalog=""
Name="dimension_work_order_variance"	REID="mdw.dimension_work_order_variance"; Selected="False"; FullName="mdw.dimension_work_order_variance"; Catalog=""
Name="dimension_year"	REID="mdw.dimension_year"; Selected="False"; FullName="mdw.dimension_year"; Catalog=""
Name="fact_account_payable"	REID="mdw.fact_account_payable"; Selected="False"; FullName="mdw.fact_account_payable"; Catalog=""
Name="fact_account_receivable"	REID="mdw.fact_account_receivable"; Selected="False"; FullName="mdw.fact_account_receivable"; Catalog=""
Name="fact_advertisement_impression"	REID="mdw.fact_advertisement_impression"; Selected="False"; FullName="mdw.fact_advertisement_impression"; Catalog=""
Name="fact_billing"	REID="mdw.fact_billing"; Selected="False"; FullName="mdw.fact_billing"; Catalog=""
Name="fact_budget_forecast"	REID="mdw.fact_budget_forecast"; Selected="False"; FullName="mdw.fact_budget_forecast"; Catalog=""
Name="fact_case"	REID="mdw.fact_case"; Selected="False"; FullName="mdw.fact_case"; Catalog=""
Name="fact_contact_center_call"	REID="mdw.fact_contact_center_call"; Selected="False"; FullName="mdw.fact_contact_center_call"; Catalog=""
Name="fact_currency_exchange"	REID="mdw.fact_currency_exchange"; Selected="True"; FullName="mdw.fact_currency_exchange"; Catalog=""
Name="fact_gl_posted_transaction"	REID="mdw.fact_gl_posted_transaction"; Selected="False"; FullName="mdw.fact_gl_posted_transaction"; Catalog=""
Name="fact_gl_snapshot"	REID="mdw.fact_gl_snapshot"; Selected="False"; FullName="mdw.fact_gl_snapshot"; Catalog=""
Name="fact_inventory_transaction"	REID="mdw.fact_inventory_transaction"; Selected="False"; FullName="mdw.fact_inventory_transaction"; Catalog=""
Name="fact_market_basket"	REID="mdw.fact_market_basket"; Selected="False"; FullName="mdw.fact_market_basket"; Catalog=""
Name="fact_order_capture"	REID="mdw.fact_order_capture"; Selected="False"; FullName="mdw.fact_order_capture"; Catalog=""
Name="fact_payable_time"	REID="mdw.fact_payable_time"; Selected="False"; FullName="mdw.fact_payable_time"; Catalog=""
Name="fact_person_application"	REID="mdw.fact_person_application"; Selected="False"; FullName="mdw.fact_person_application"; Catalog=""
Name="fact_physical_inventory"	REID="mdw.fact_physical_inventory"; Selected="False"; FullName="mdw.fact_physical_inventory"; Catalog=""
Name="fact_procurement"	REID="mdw.fact_procurement"; Selected="False"; FullName="mdw.fact_procurement"; Catalog=""
Name="fact_purchase_order"	REID="mdw.fact_purchase_order"; Selected="False"; FullName="mdw.fact_purchase_order"; Catalog=""
Name="fact_requisition"	REID="mdw.fact_requisition"; Selected="False"; FullName="mdw.fact_requisition"; Catalog=""
Name="fact_return"	REID="mdw.fact_return"; Selected="False"; FullName="mdw.fact_return"; Catalog=""
Name="fact_sales_lead"	REID="mdw.fact_sales_lead"; Selected="False"; FullName="mdw.fact_sales_lead"; Catalog=""
Name="fact_sales_opportunity"	REID="mdw.fact_sales_opportunity"; Selected="False"; FullName="mdw.fact_sales_opportunity"; Catalog=""
Name="fact_shipment"	REID="mdw.fact_shipment"; Selected="False"; FullName="mdw.fact_shipment"; Catalog=""
Name="fact_shipping_notice"	REID="mdw.fact_shipping_notice"; Selected="False"; FullName="mdw.fact_shipping_notice"; Catalog=""
Name="fact_warehouse_receipt"	REID="mdw.fact_warehouse_receipt"; Selected="False"; FullName="mdw.fact_warehouse_receipt"; Catalog=""
Name="fact_web_page_view"	REID="mdw.fact_web_page_view"; Selected="False"; FullName="mdw.fact_web_page_view"; Catalog=""
Name="fact_web_site_referer"	REID="mdw.fact_web_site_referer"; Selected="False"; FullName="mdw.fact_web_site_referer"; Catalog=""
Name="fact_web_site_visit"	REID="mdw.fact_web_site_visit"; Selected="False"; FullName="mdw.fact_web_site_visit"; Catalog=""
Name="fact_work_order"	REID="mdw.fact_work_order"; Selected="False"; FullName="mdw.fact_work_order"; Catalog=""
Name="fact_workforce_overview"	REID="mdw.fact_workforce_overview"; Selected="False"; FullName="mdw.fact_workforce_overview"; Catalog=""
Name="stage_account"	REID="mdw.stage_account"; Selected="False"; FullName="mdw.stage_account"; Catalog=""
Name="stage_advertisement"	REID="mdw.stage_advertisement"; Selected="False"; FullName="mdw.stage_advertisement"; Catalog=""
Name="stage_advertisement_impression"	REID="mdw.stage_advertisement_impression"; Selected="False"; FullName="mdw.stage_advertisement_impression"; Catalog=""
Name="stage_bank_account"	REID="mdw.stage_bank_account"; Selected="False"; FullName="mdw.stage_bank_account"; Catalog=""
Name="stage_bill_status"	REID="mdw.stage_bill_status"; Selected="False"; FullName="mdw.stage_bill_status"; Catalog=""
Name="stage_bill_type"	REID="mdw.stage_bill_type"; Selected="False"; FullName="mdw.stage_bill_type"; Catalog=""
Name="stage_billing"	REID="mdw.stage_billing"; Selected="False"; FullName="mdw.stage_billing"; Catalog=""
Name="stage_budget_forecast"	REID="mdw.stage_budget_forecast"; Selected="False"; FullName="mdw.stage_budget_forecast"; Catalog=""
Name="stage_budget_forecast_item"	REID="mdw.stage_budget_forecast_item"; Selected="False"; FullName="mdw.stage_budget_forecast_item"; Catalog=""
Name="stage_budget_forecast_measures"	REID="mdw.stage_budget_forecast_measures"; Selected="False"; FullName="mdw.stage_budget_forecast_measures"; Catalog=""
Name="stage_business_unit"	REID="mdw.stage_business_unit"; Selected="False"; FullName="mdw.stage_business_unit"; Catalog=""
Name="stage_campaign_wave"	REID="mdw.stage_campaign_wave"; Selected="False"; FullName="mdw.stage_campaign_wave"; Catalog=""
Name="stage_carrier"	REID="mdw.stage_carrier"; Selected="False"; FullName="mdw.stage_carrier"; Catalog=""
Name="stage_classification"	REID="mdw.stage_classification"; Selected="False"; FullName="mdw.stage_classification"; Catalog=""
Name="stage_company"	REID="mdw.stage_company"; Selected="False"; FullName="mdw.stage_company"; Catalog=""
Name="stage_company_paygroup"	REID="mdw.stage_company_paygroup"; Selected="False"; FullName="mdw.stage_company_paygroup"; Catalog=""
Name="stage_contract"	REID="mdw.stage_contract"; Selected="False"; FullName="mdw.stage_contract"; Catalog=""
Name="stage_cost_center"	REID="mdw.stage_cost_center"; Selected="False"; FullName="mdw.stage_cost_center"; Catalog=""
Name="stage_currency"	REID="mdw.stage_currency"; Selected="False"; FullName="mdw.stage_currency"; Catalog=""
Name="stage_customer"	REID="mdw.stage_customer"; Selected="False"; FullName="mdw.stage_customer"; Catalog=""
Name="stage_customer_contact"	REID="mdw.stage_customer_contact"; Selected="False"; FullName="mdw.stage_customer_contact"; Catalog=""
Name="stage_department"	REID="mdw.stage_department"; Selected="False"; FullName="mdw.stage_department"; Catalog=""
Name="stage_document_type"	REID="mdw.stage_document_type"; Selected="False"; FullName="mdw.stage_document_type"; Catalog=""
Name="stage_employee_job_action"	REID="mdw.stage_employee_job_action"; Selected="False"; FullName="mdw.stage_employee_job_action"; Catalog=""
Name="stage_fiscal_day"	REID="mdw.stage_fiscal_day"; Selected="False"; FullName="mdw.stage_fiscal_day"; Catalog=""
Name="stage_fund"	REID="mdw.stage_fund"; Selected="False"; FullName="mdw.stage_fund"; Catalog=""
Name="stage_geo_city_blocks"	REID="mdw.stage_geo_city_blocks"; Selected="False"; FullName="mdw.stage_geo_city_blocks"; Catalog=""
Name="stage_geo_city_location"	REID="mdw.stage_geo_city_location"; Selected="False"; FullName="mdw.stage_geo_city_location"; Catalog=""
Name="stage_geo_dma"	REID="mdw.stage_geo_dma"; Selected="False"; FullName="mdw.stage_geo_dma"; Catalog=""
Name="stage_geo_iso_country"	REID="mdw.stage_geo_iso_country"; Selected="False"; FullName="mdw.stage_geo_iso_country"; Catalog=""
Name="stage_geo_iso_country_fips_reg"	REID="mdw.stage_geo_iso_country_fips_reg"; Selected="False"; FullName="mdw.stage_geo_iso_country_fips_reg"; Catalog=""
Name="stage_geo_iso_country_iso_reg"	REID="mdw.stage_geo_iso_country_iso_reg"; Selected="False"; FullName="mdw.stage_geo_iso_country_iso_reg"; Catalog=""
Name="stage_geo_organization"	REID="mdw.stage_geo_organization"; Selected="False"; FullName="mdw.stage_geo_organization"; Catalog=""
Name="stage_gl_adjustment"	REID="mdw.stage_gl_adjustment"; Selected="False"; FullName="mdw.stage_gl_adjustment"; Catalog=""
Name="stage_gl_book"	REID="mdw.stage_gl_book"; Selected="False"; FullName="mdw.stage_gl_book"; Catalog=""
Name="stage_gl_posted_transaction"	REID="mdw.stage_gl_posted_transaction"; Selected="False"; FullName="mdw.stage_gl_posted_transaction"; Catalog=""
Name="stage_inventory_adjustment"	REID="mdw.stage_inventory_adjustment"; Selected="False"; FullName="mdw.stage_inventory_adjustment"; Catalog=""
Name="stage_inventory_transaction"	REID="mdw.stage_inventory_transaction"; Selected="False"; FullName="mdw.stage_inventory_transaction"; Catalog=""
Name="stage_job_action"	REID="mdw.stage_job_action"; Selected="False"; FullName="mdw.stage_job_action"; Catalog=""
Name="stage_jobcode"	REID="mdw.stage_jobcode"; Selected="False"; FullName="mdw.stage_jobcode"; Catalog=""
Name="stage_ledger"	REID="mdw.stage_ledger"; Selected="False"; FullName="mdw.stage_ledger"; Catalog=""
Name="stage_location"	REID="mdw.stage_location"; Selected="False"; FullName="mdw.stage_location"; Catalog=""
Name="stage_marketing_channel"	REID="mdw.stage_marketing_channel"; Selected="False"; FullName="mdw.stage_marketing_channel"; Catalog=""
Name="stage_marketing_segment"	REID="mdw.stage_marketing_segment"; Selected="False"; FullName="mdw.stage_marketing_segment"; Catalog=""
Name="stage_operating_unit"	REID="mdw.stage_operating_unit"; Selected="False"; FullName="mdw.stage_operating_unit"; Catalog=""
Name="stage_order"	REID="mdw.stage_order"; Selected="False"; FullName="mdw.stage_order"; Catalog=""
Name="stage_order_status"	REID="mdw.stage_order_status"; Selected="False"; FullName="mdw.stage_order_status"; Catalog=""
Name="stage_order_type"	REID="mdw.stage_order_type"; Selected="False"; FullName="mdw.stage_order_type"; Catalog=""
Name="stage_payment_method"	REID="mdw.stage_payment_method"; Selected="False"; FullName="mdw.stage_payment_method"; Catalog=""
Name="stage_payment_terms"	REID="mdw.stage_payment_terms"; Selected="False"; FullName="mdw.stage_payment_terms"; Catalog=""
Name="stage_person"	REID="mdw.stage_person"; Selected="False"; FullName="mdw.stage_person"; Catalog=""
Name="stage_physical_inventory"	REID="mdw.stage_physical_inventory"; Selected="False"; FullName="mdw.stage_physical_inventory"; Catalog=""
Name="stage_position"	REID="mdw.stage_position"; Selected="False"; FullName="mdw.stage_position"; Catalog=""
Name="stage_product"	REID="mdw.stage_product"; Selected="False"; FullName="mdw.stage_product"; Catalog=""
Name="stage_product_lot"	REID="mdw.stage_product_lot"; Selected="False"; FullName="mdw.stage_product_lot"; Catalog=""
Name="stage_program"	REID="mdw.stage_program"; Selected="False"; FullName="mdw.stage_program"; Catalog=""
Name="stage_project"	REID="mdw.stage_project"; Selected="False"; FullName="mdw.stage_project"; Catalog=""
Name="stage_purchase_order"	REID="mdw.stage_purchase_order"; Selected="False"; FullName="mdw.stage_purchase_order"; Catalog=""
Name="stage_region"	REID="mdw.stage_region"; Selected="False"; FullName="mdw.stage_region"; Catalog=""
Name="stage_return"	REID="mdw.stage_return"; Selected="False"; FullName="mdw.stage_return"; Catalog=""
Name="stage_return_reason"	REID="mdw.stage_return_reason"; Selected="False"; FullName="mdw.stage_return_reason"; Catalog=""
Name="stage_return_type"	REID="mdw.stage_return_type"; Selected="False"; FullName="mdw.stage_return_type"; Catalog=""
Name="stage_salary_plan"	REID="mdw.stage_salary_plan"; Selected="False"; FullName="mdw.stage_salary_plan"; Catalog=""
Name="stage_sales_channel"	REID="mdw.stage_sales_channel"; Selected="False"; FullName="mdw.stage_sales_channel"; Catalog=""
Name="stage_statistics"	REID="mdw.stage_statistics"; Selected="False"; FullName="mdw.stage_statistics"; Catalog=""
Name="stage_subledger"	REID="mdw.stage_subledger"; Selected="False"; FullName="mdw.stage_subledger"; Catalog=""
Name="stage_supplier"	REID="mdw.stage_supplier"; Selected="False"; FullName="mdw.stage_supplier"; Catalog=""
Name="stage_transaction_status"	REID="mdw.stage_transaction_status"; Selected="False"; FullName="mdw.stage_transaction_status"; Catalog=""
Name="stage_transaction_type"	REID="mdw.stage_transaction_type"; Selected="False"; FullName="mdw.stage_transaction_type"; Catalog=""
Name="stage_tree_account"	REID="mdw.stage_tree_account"; Selected="False"; FullName="mdw.stage_tree_account"; Catalog=""
Name="stage_unit_of_measure"	REID="mdw.stage_unit_of_measure"; Selected="False"; FullName="mdw.stage_unit_of_measure"; Catalog=""
Name="stage_warehouse"	REID="mdw.stage_warehouse"; Selected="False"; FullName="mdw.stage_warehouse"; Catalog=""
Name="stage_web_bot_list"	REID="mdw.stage_web_bot_list"; Selected="False"; FullName="mdw.stage_web_bot_list"; Catalog=""
Name="stage_web_request"	REID="mdw.stage_web_request"; Selected="False"; FullName="mdw.stage_web_request"; Catalog=""
Name="stage_web_visitor"	REID="mdw.stage_web_visitor"; Selected="False"; FullName="mdw.stage_web_visitor"; Catalog=""
Name="stage_work_order"	REID="mdw.stage_work_order"; Selected="False"; FullName="mdw.stage_work_order"; Catalog=""
Name="stage_work_order_category"	REID="mdw.stage_work_order_category"; Selected="False"; FullName="mdw.stage_work_order_category"; Catalog=""
Name="stage_work_order_phase"	REID="mdw.stage_work_order_phase"; Selected="False"; FullName="mdw.stage_work_order_phase"; Catalog=""
Name="stage_work_order_status"	REID="mdw.stage_work_order_status"; Selected="False"; FullName="mdw.stage_work_order_status"; Catalog=""
Name="stage_work_order_type"	REID="mdw.stage_work_order_type"; Selected="False"; FullName="mdw.stage_work_order_type"; Catalog=""
Name="stage_work_order_variance"	REID="mdw.stage_work_order_variance"; Selected="False"; FullName="mdw.stage_work_order_variance"; Catalog=""
Name="tree_account"	REID="mdw.tree_account"; Selected="False"; FullName="mdw.tree_account"; Catalog=""
************	
***Columns***	
Name="CURRENCY_FROM_SK"	REID="mdw.fact_currency_exchange.CURRENCY_FROM_SK"; TableREID="mdw.fact_currency_exchange"; TableName=""; TableOwner=""; TableSchema=""; TableCatalog=""
Name="CURRENCY_TO_SK"	REID="mdw.fact_currency_exchange.CURRENCY_TO_SK"; TableREID="mdw.fact_currency_exchange"; TableName=""; TableOwner=""; TableSchema=""; TableCatalog=""
Name="EXCHANGE_RATE_START_DATE_SK"	REID="mdw.fact_currency_exchange.EXCHANGE_RATE_START_DATE_SK"; TableREID="mdw.fact_currency_exchange"; TableName=""; TableOwner=""; TableSchema=""; TableCatalog=""
Name="EXCHANGE_RATE_STOP_DATE_SK"	REID="mdw.fact_currency_exchange.EXCHANGE_RATE_STOP_DATE_SK"; TableREID="mdw.fact_currency_exchange"; TableName=""; TableOwner=""; TableSchema=""; TableCatalog=""
Name="EXCHANGE_RATE_START_DATE"	REID="mdw.fact_currency_exchange.EXCHANGE_RATE_START_DATE"; TableREID="mdw.fact_currency_exchange"; TableName=""; TableOwner=""; TableSchema=""; TableCatalog=""
Name="EXCHANGE_RATE_STOP_DATE"	REID="mdw.fact_currency_exchange.EXCHANGE_RATE_STOP_DATE"; TableREID="mdw.fact_currency_exchange"; TableName=""; TableOwner=""; TableSchema=""; TableCatalog=""
Name="EXCHANGE_RATE"	REID="mdw.fact_currency_exchange.EXCHANGE_RATE"; TableREID="mdw.fact_currency_exchange"; TableName=""; TableOwner=""; TableSchema=""; TableCatalog=""
Name="HOSTED_CLIENT_SK"	REID="mdw.fact_currency_exchange.HOSTED_CLIENT_SK"; TableREID="mdw.fact_currency_exchange"; TableName=""; TableOwner=""; TableSchema=""; TableCatalog=""
Name="DW_LOAD_DATE"	REID="mdw.fact_currency_exchange.DW_LOAD_DATE"; TableREID="mdw.fact_currency_exchange"; TableName=""; TableOwner=""; TableSchema=""; TableCatalog=""
************	
